0000000000
0000000000
0000000000
0000011100
0000000001
0000011001
0000000001
0111110001
0000000000
0000001100