0000000000
0000111110
1000011100
1001000000
0001000000
0001000110
0001000000
0000000000
0000000000
0000000000