0000000000
0000000000
0001000010
0001000010
0000000010
0000111100
0000000000
0000000001
0011111001