1110000000
0000001000
0011001000
0000001000
0000001000
0000000000
0001111100
0000000000
0001100000
0000000000