0000000000
0000000000
0001100000
1000000111
1000000000
1000000000
1000011110
1000000000
0000011000
0000000000