0001110000
0000000011
0000000000
0001111100
0000000000
0000000001
0000000001
0000000001
0000000001
0011000000