0000000000
0000000000
0001111000
0000000011
1111100000
0000000100
0000000100
0000000100
0000000011
0000000000
