0000000000
0000110000
0000000000
0111001000
0000001001
0000001001
0000001001
0000001001
0000001000
0110000000