0000000000
0000000001
0000000001
1111000001
0000001100
1111100000
0000000000
0000000011
0000000000
0000000000