0011111000
0000000011
0000000000
0000000000
0000000000
0000111000
0000000000
0000000110
0111100000
0000000000